0.105084 5 2.85653e-017 0.999988 -0.0047977 4.42999e-018 0.0047977 0.999988 1.64322e-017
0.206683 5 5.00795 0.99993 -0.0116006 0.00244129 0.0115494 0.999732 0.020047
5
dom.obj
-20 -1 -15 1 0 0 0 1 0
4 4 4
dom.obj
-5 -1 -15 1 0 0 0 1 0
4 4 4
dom.obj
10 -1 -15 1 0 0 0 1 0
4 4 4
dom.obj
25 -1 -15 1 0 0 0 1 0
4 4 4
dom.obj
40 -1 -15 1 0 0 0 1 0
4 4 4
3
5
40 2 0 1 0 0
40 2 -30 1 0 0
-20 2 -30 1 0 0
-20 2 0 1 0 0
0 2 0 1 0 0
****************************************
****************************************
****************************************
****************************************
****************************************
****************************************
****************************************
****************************************
****************************************
****************************************
****************************************
****************************************
****************************************
******##################################
******##--------------------------------
******#|################################
******#|#*********************#|#*******
******#|#*********************#|#*******
########################################
----------------------------------------
########################################
*****************#|#****#|#*************
*****************#|#****#|#*************
*****************#|#****#|#*************
*****************#|#****#|#*************
*****************#|######|#*************
*****************#|#-----##*************
*****************#|########*************
*****************#|#********************
*****************#|#********************
*****************#|#********************
*****************#|#********************
*****************#|#********************
*****************#|#********************
*****************#|#********************
*****************#|#********************
*****************#|#********************
*****************#|#********************
*****************#|#********************
*****************#|#********************
                                        
                                        
                                        
                                        
                                        
                                        
                                        
                                        
                                        
                                        
                                        
                                        
                                        
      ((((((((((((((((((((((((((((((((((
      ((((((((((((((((((((((((((((((((((
      ((((((((((((((((((((((((((((((((((
      ((((((((((((((((((((((((((((((((((
      ((((                    ((((      
((((((((((((((((((((((((((((((((((((((((
((((((((((((((((((((((((((((((((((((((((
((((((((((((((((((((((((((((((((((((((((
((((((((((((((((((((((((((((((((((((((((
                 (((((((((((            
                 (((((((((((            
                 (((((((((((            
                 (((((((((((            
                 (((((((((((            
                 (((((((((((            
                 (((((((((((            
                 ((((                   
                 ((((                   
                 ((((                   
                 ((((                   
                 ((((                   
                 ((((                   
                 ((((                   
                 ((((                   
                 ((((                   
                 ((((                   
                 ((((                   
